d  ########  ##
 #  #       ###
  #   ####### #
#  ##   #     #
## #### # #####
## ####      ##
#     ######  #
  ###   #  # ##
# ##### ## # ##
# ###   ##   ##
#   # #########
### #    ##   #
# # # ##    # #
#   # ### ### #
### ##### ### a